_________________
|@      |        |
|       |        |
|       |        |
|       |        |
|_______|________|
