                                                                    
&&&&&&&&&&&&&&&&&&&&&&&&&&&   &&&&&&&&&&&&&&&&&&&&&&&&&&&           
&,                       &&   &@                       #&           
&,   &*   &&&&&&&&&&&&&&&&&   &&   &&&&&&&&&&&&&&&&&&&&&&           
&,   &*                            &&                  #&           
&,   &&&&&&/   &&&&&&&&&&&&&&&&&   &&   @&&&&&&   &&   #&           
&,        &/   &(                  &&   &&   @&   &&   #&           
&&&&&&&&&&&/   &&&&&&&&&&&&&&&&&&&&&&   &&   @&   &&   #&           
&,             &(                       &&        &&   #&           
&,   &*   &&&&&&#   &&&&&&&&&&&&&&&&&&&&&&   @&&&&&&&&&&&           
&,   &*             &%                  &&             #&           
&,   &&&&&&&&&&&&&&&&%   &&   &&&&&&&&&&&&&&&&&&&&&&   #&           
&,   &*             &%   &&                            #&           
&,   &*   &&&&&&(   &%   &&&&&&&&&&&&&&&&&&&&&&&&&&&   #&           
&,   &*   &/   &(   &%                  &&        &&   #&           
&,   &*   &/   &(   &&&&&&&&&&&&&&&&&   &&   @&&&&&&   #&           
&,   &*   &/                       &&   &&             #&           
&,   &*   &&&&&&&&&&&&&&&&&&&&&@   &&   &&&&&&&&&&&&&&&&&           
&,   &*                       &@   &&                  #&           
&,   &&&&&&&&&&&&&&&&&&&&&&   &@   &&&&&&&&&&&&&&&&&   #&           
&,                  &%        &@        &&             #&           
&&&&&&&&&&&&&&&&(   &%   &&&&&&&&&&&&   &&   @&&&&&&&&&&&           
&,                  &%        &@                       #&           
&&&&&&&&&&&&&&&&&&&&&&&&&&&   &&&&&&&&&&&&&&&&&&&&&&&&&&&
                            0
