###############
##          ###
## ######   ###
## ### @    ###
## ###      ###
## ######   ###
##          ###
###############