###################################
####                          #####
##########################    #####
##########################    #####
##########################    #####
##########################    #####
##########################    #####
##########################    #####
##########################    #####
##########################    #####
##########################    #####
##########################    #####

###################################
###################################
###################################
###################################
###################################
###################################
###################################
###################################
###################################